#######################
#*#    X              #
# # X$   ###########  #
# ########            #
#        # ############
# ###### #            #
# #    # ############ #
# #### #     #        #
#    # ##### #  XXXXXX#
# XXX#       #        #
#    #########XXXXXXX #
#  X                  #
#######################
